ABR	ABR
ADJ	ADJ
ADV	ADV
DET:ART	DET:ART
DET:POS	DET:POS
INT	INT
KON	KON
NAM	NAM
NOM	NOM
NUM	NUM
PRO	PRO
PRO:DEM	PRO:DEM
PRO:IND	PRO:IND
PRO:PER	PRO:PER
PRO:POS	PRO:POS
PRO:REL	PRO:REL
PRP	PRP
PRP:det	PRP:det
PUN	PUN
PUN:cit	PUN:cit
SENT	SENT
SYM	SYM
VER:cond	VERB
VER:futu	VERB
VER:impe	VERB
VER:impf	VERB
VER:infi	VERB
VER:pper	VERB
VER:ppre	VERB
VER:pres	VERB
VER:simp	VERB
VER:subi	VERB
VER:subp	VERB
PREF	PREF
NN	NN
